11111111111
1P0000C0001
1C0000000E1
11111111111
