111111
1P0001
111001
  1001
  1C01
  10E1
  1111