111111
1P0101
1C01E1
111111
